Table of Content:
Part 1: The Java Language
Chapter I : The History and Evolution of Java
Chapter II : An Overview of Java
Chapter III : Data Types, Variables, and Arrays
Chapter IV : Operators
Chapter V : Control Statements
Chapter VI : Introducing Classes
Chapter VII : A Closer Look at Methods and Classes
Chapter VIII : Inheritance
Chapter IX : Packages and Interfaces
Chapter X : Exception Handling
Chapter XI : Multithreaded Programming
Chapter XII : Enumeration, Autoboxing, and Annotations
Chapter XIII : I/O, Try-with-Resources, and Other Topics
Chapter XIV : Generics
Chapter XV : Lambda Expressions
Chapter XVI : Modules

Part 2: The Java Library
Chapter XVII : String Handling
Chapter XVIII : Exploring java.lang
Chapter XIX : java.util: The Collections Framework
Chapter XX : java.util: More Utility Classes
Chapter XXI : Input/Output Exploring java.io
Chapter XXII : Exploring NIO
Chapter XXIII : Networking
Chapter XXIV : Event Handling
Chapter XXV : Introducing the AWT: Working with Windows, Graphics and Text
Chapter XXVI : Using AWT Controls, Layout Managers, and Menus
Chapter XXVII : Images
Chapter XXVIII : The Concurrency Utilities
Chapter XXIX : The Stream API
Chapter XXX: Regular Expressions and Other Packages

Part 3: Introducing GUI Programming with Swing
Chapter XXXI : Introducing Swing
Chapter XXXII : Exploring Swing
Chapter XXXIII : Introducing Swing Menus

Part 4: Applying Java
Chapter XXXIV: Java Beans
Chapter XXXV: Introducing Servlets

Part 5: Appendixes